RIGHT x 3
DOWN
RIGHT
UP
OPEN_CHEST
LEFT
UP
LEFT x 3
UP x 2
LEFT x 3
DOWN x 2
LEFT x 2

##############
#       ###B##
#    ## ##   #
# ↓  ##@   C #
####### ##   #
####### ##   #
##      ######
##############

RIGHT
##############
#       ###B##
#    ## ##   #
# ↓  ## @  C #
####### ##   #
####### ##   #
##      ######
##############

RIGHT
##############
#       ###B##
#    ## ##   #
# ↓  ##  @ C #
####### ##   #
####### ##   #
##      ######
##############

RIGHT
##############
#       ###B##
#    ## ##   #
# ↓  ##   @C #
####### ##   #
####### ##   #
##      ######
##############

DOWN
##############
#       ###B##
#    ## ##   #
# ↓  ##    C #
####### ##@  #
####### ##   #
##      ######
##############

RIGHT
##############
#       ###B##
#    ## ##   #
# ↓  ##    C #
####### ## @ #
####### ##   #
##      ######
##############

UP
##############
#       ###B##
#    ## ##   #
# ↓  ##    C #
####### ## @ #
####### ##   #
##      ######
##############

OPEN_CHEST
##############
#       ###B##
#    ## ##   #
# ↓  ##    c #
####### ## @ #
####### ##   #
##      ######
##############

LEFT
##############
#       ###B##
#    ## ##   #
# ↓  ##    c #
####### ##@  #
####### ##   #
##      ######
##############

UP
##############
#       ###B##
#    ## ##   #
# ↓  ##   @c #
####### ##   #
####### ##   #
##      ######
##############

LEFT
##############
#       ###B##
#    ## ##   #
# ↓  ##  @ c #
####### ##   #
####### ##   #
##      ######
##############

LEFT
##############
#       ###B##
#    ## ##   #
# ↓  ## @  c #
####### ##   #
####### ##   #
##      ######
##############

LEFT
##############
#       ###B##
#    ## ##   #
# ↓  ##@   c #
####### ##   #
####### ##   #
##      ######
##############

UP
##############
#       ###B##
#    ##@##   #
# ↓  ##    c #
####### ##   #
####### ##   #
##      ######
##############

UP
##############
#      @###B##
#    ## ##   #
# ↓  ##    c #
####### ##   #
####### ##   #
##      ######
##############

LEFT
##############
#     @ ###B##
#    ## ##   #
# ↓  ##    c #
####### ##   #
####### ##   #
##      ######
##############

LEFT
##############
#    @  ###B##
#    ## ##   #
# ↓  ##    c #
####### ##   #
####### ##   #
##      ######
##############

LEFT
##############
#   @   ###B##
#    ## ##   #
# ↓  ##    c #
####### ##   #
####### ##   #
##      ######
##############

DOWN
##############
#       ###B##
#   @## ##   #
# ↓  ##    c #
####### ##   #
####### ##   #
##      ######
##############

DOWN
##############
#       ###B##
#    ## ##   #
# ↓ @##    c #
####### ##   #
####### ##   #
##      ######
##############

LEFT
##############
#       ###B##
#    ## ##   #
# ↓@ ##    c #
####### ##   #
####### ##   #
##      ######
##############

LEFT
##############
#       ###B##
#    ## ##   #
# @  ##    c #
####### ##   #
####### ##   #
##      ######
##############

