UP
LEFT
UP
RIGHT x 2
UP x 2
LEFT x 2
UP
RIGHT x 12
DOWN x 3
RIGHT x 2
DOWN
LEFT x 2

############
##x#########
#         ##
#BBB####   #
#   ####BBx#
# @ ###x↓  #
####### BBx#
############

UP
############
##x#########
#         ##
#BBB####   #
# @ ####BBx#
#   ###x↓  #
####### BBx#
############

LEFT
############
##x#########
#         ##
#BBB####   #
#@  ####BBx#
#   ###x↓  #
####### BBx#
############

UP
############
##x#########
#B        ##
# BB####   #
#@  ####BBx#
#   ###x↓  #
####### BBx#
############

RIGHT
############
##x#########
#B        ##
# BB####   #
# @ ####BBx#
#   ###x↓  #
####### BBx#
############

RIGHT
############
##x#########
#B        ##
# BB####   #
#  @####BBx#
#   ###x↓  #
####### BBx#
############

UP
############
##x#########
#B B      ##
# B ####   #
#  @####BBx#
#   ###x↓  #
####### BBx#
############

UP
############
##x#########
#B B      ##
# B@####   #
#   ####BBx#
#   ###x↓  #
####### BBx#
############

LEFT
############
##x#########
#B B      ##
#B @####   #
#   ####BBx#
#   ###x↓  #
####### BBx#
############

LEFT
############
##x#########
#B B      ##
#B@ ####   #
#   ####BBx#
#   ###x↓  #
####### BBx#
############

UP
############
##x#########
#B@B      ##
#B  ####   #
#   ####BBx#
#   ###x↓  #
####### BBx#
############

RIGHT
############
##x#########
#B@ B     ##
#B  ####   #
#   ####BBx#
#   ###x↓  #
####### BBx#
############

RIGHT
############
##x#########
#B @B     ##
#B  ####   #
#   ####BBx#
#   ###x↓  #
####### BBx#
############

RIGHT
############
##x#########
#B @ B    ##
#B  ####   #
#   ####BBx#
#   ###x↓  #
####### BBx#
############

RIGHT
############
##x#########
#B  @B    ##
#B  ####   #
#   ####BBx#
#   ###x↓  #
####### BBx#
############

RIGHT
############
##x#########
#B  @ B   ##
#B  ####   #
#   ####BBx#
#   ###x↓  #
####### BBx#
############

RIGHT
############
##x#########
#B   @B   ##
#B  ####   #
#   ####BBx#
#   ###x↓  #
####### BBx#
############

RIGHT
############
##x#########
#B   @ B  ##
#B  ####   #
#   ####BBx#
#   ###x↓  #
####### BBx#
############

RIGHT
############
##x#########
#B    @B  ##
#B  ####   #
#   ####BBx#
#   ###x↓  #
####### BBx#
############

RIGHT
############
##x#########
#B    @ B ##
#B  ####   #
#   ####BBx#
#   ###x↓  #
####### BBx#
############

RIGHT
############
##x#########
#B     @B ##
#B  ####   #
#   ####BBx#
#   ###x↓  #
####### BBx#
############

RIGHT
############
##x#########
#B     @ B##
#B  ####   #
#   ####BBx#
#   ###x↓  #
####### BBx#
############

RIGHT
############
##x#########
#B      @B##
#B  ####   #
#   ####BBx#
#   ###x↓  #
####### BBx#
############

DOWN
############
##x#########
#B       B##
#B  ####@  #
#   ####BBx#
#   ###x↓  #
####### BBx#
############

DOWN
############
##x#########
#B       B##
#B  ####@  #
#   #### Bx#
#   ###xB  #
####### BBx#
############

DOWN
############
##x#########
#B       B##
#B  ####   #
#   ####@Bx#
#   ###xB  #
####### BBx#
############

RIGHT
############
##x#########
#B       B##
#B  ####   #
#   ####@ x#
#   ###xB  #
####### BBx#
############

RIGHT
############
##x#########
#B       B##
#B  ####   #
#   #### @x#
#   ###xB  #
####### BBx#
############

DOWN
############
##x#########
#B       B##
#B  ####   #
#   ####  x#
#   ###xB@ #
####### BBx#
############

LEFT
############
##x#########
#B       B##
#B  ####   #
#   ####  x#
#   ###x↓@ #
####### BBx#
############

LEFT
############
##x#########
#B       B##
#B  ####   #
#   ####  x#
#   ###x@  #
####### BBx#
############

