RIGHT x 9

##############
######  ######
######  ######
#            #
# @        ↓ #
#            #
##############

RIGHT
##############
######  ######
######  ######
#            #
#  @       ↓ #
#            #
##############

RIGHT
##############
######  ######
######  ######
#            #
#   @      ↓ #
#            #
##############

RIGHT
##############
######  ######
######  ######
#            #
#    @     ↓ #
#            #
##############

RIGHT
##############
######  ######
######  ######
#            #
#     @    ↓ #
#            #
##############

RIGHT
##############
######  ######
######  ######
#            #
#      @   ↓ #
#            #
##############

RIGHT
##############
######  ######
######  ######
#            #
#       @  ↓ #
#            #
##############

RIGHT
##############
######  ######
######  ######
#            #
#        @ ↓ #
#            #
##############

RIGHT
##############
######  ######
######  ######
#            #
#         @↓ #
#            #
##############

RIGHT
##############
######  ######
######  ######
#            #
#          @ #
#            #
##############

